{
    "config" : {
        "swapTime" : [7, 20, 7, 20, 5, 20, 5]
    },

    "Line1"  : ["/ / / / / / / / / / / / / / / / / / / / / / / / / / / /"], 
    "Line2"  : ["/ / / / / / / / / / / / / / / / / / / / / / / / / / / /"], 
    "Line3"  : ["/ / / / / / / / / / / / / / / / / / / / / / / / / / / /"], 
    "Line4"  : ["□ □ □ □ □ □ □ □ □ □ □ □ □ □ □ □ □ □ □ □ □ □ □ □ □ □ □ □"], 
    "Line5"  : ["□ ◦ ◦ ◦ ◦ ◦ ◦ ◦ ◦ ◦ ◦ ◦ ◦ ■ ■ ◦ ◦ ◦ ◦ ◦ ◦ ◦ ◦ ◦ ◦ ◦ ◦ □"], 
    "Line6"  : ["□ ◦ ■ ■ ■ ■ ◦ ■ ■ ■ ■ ■ ◦ ■ ■ ◦ ■ ■ ■ ■ ■ ◦ ■ ■ ■ ■ ◦ □"], 
    "Line7"  : ["□ ● ■ ■ ■ ■ ◦ ■ ■ ■ ■ ■ ◦ ■ ■ ◦ ■ ■ ■ ■ ■ ◦ ■ ■ ■ ■ ● □"], 
    "Line8"  : ["□ ◦ ■ ■ ■ ■ ◦ ■ ■ ■ ■ ■ ◦ ■ ■ ◦ ■ ■ ■ ■ ■ ◦ ■ ■ ■ ■ ◦ □"], 
    "Line9"  : ["□ ◦ ◦ ◦ ◦ ◦ ◦ ◦ ◦ ◦ ◦ ◦ ◦ ◦ ◦ ◦ ◦ ◦ ◦ ◦ ◦ ◦ ◦ ◦ ◦ ◦ ◦ □"], 
    "Line10" : ["□ ◦ ■ ■ ■ ■ ◦ ■ ■ ◦ ■ ■ ■ ■ ■ ■ ■ ■ ◦ ■ ■ ◦ ■ ■ ■ ■ ◦ □"], 
    "Line11" : ["□ ◦ ■ ■ ■ ■ ◦ ■ ■ ◦ ■ ■ ■ ■ ■ ■ ■ ■ ◦ ■ ■ ◦ ■ ■ ■ ■ ◦ □"], 
    "Line12" : ["□ ◦ ◦ ◦ ◦ ◦ ◦ ■ ■ ◦ ◦ ◦ ◦ ■ ■ ◦ ◦ ◦ ◦ ■ ■ ◦ ◦ ◦ ◦ ◦ ◦ □"], 
    "Line13" : ["□ □ □ □ □ □ ◦ ■ ■ ■ ■ ■ / ■ ■ / ■ ■ ■ ■ ■ ◦ □ □ □ □ □ □"], 
    "Line14" : ["/ / / / / □ ◦ ■ ■ ■ ■ ■ / ■ ■ / ■ ■ ■ ■ ■ ◦ □ / / / / /"], 
    "Line15" : ["/ / / / / □ ◦ ■ ■ / / x x x x x x / / ■ ■ ◦ □ / / / / /"], 
    "Line16" : ["/ / / / / □ ◦ ■ ■ / ■ ■ ■ s s ■ ■ ■ / ■ ■ ◦ □ / / / / /"], 
    "Line17" : ["□ □ □ □ □ □ ◦ ■ ■ / ■ s s s s s s ■ / ■ ■ ◦ □ □ □ □ □ □"], 
    "Line18" : ["= = = = = = ◦ / / / ■ s s s s s s ■ / / / ◦ = = = = = ="], 
    "Line19" : ["□ □ □ □ □ □ ◦ ■ ■ / ■ s s s s s s ■ / ■ ■ ◦ □ □ □ □ □ □"], 
    "Line20" : ["/ / / / / □ ◦ ■ ■ / ■ ■ ■ ■ ■ ■ ■ ■ / ■ ■ ◦ □ / / / / /"], 
    "Line21" : ["/ / / / / □ ◦ ■ ■ / / / / / / / / / / ■ ■ ◦ □ / / / / /"], 
    "Line22" : ["/ / / / / □ ◦ ■ ■ / ■ ■ ■ ■ ■ ■ ■ ■ / ■ ■ ◦ □ / / / / /"], 
    "Line23" : ["□ □ □ □ □ □ ◦ ■ ■ / ■ ■ ■ ■ ■ ■ ■ ■ / ■ ■ ◦ □ □ □ □ □ □"], 
    "Line24" : ["□ ◦ ◦ ◦ ◦ ◦ ◦ ◦ ◦ ◦ ◦ ◦ ◦ ■ ■ ◦ ◦ ◦ ◦ ◦ ◦ ◦ ◦ ◦ ◦ ◦ ◦ □"], 
    "Line25" : ["□ ◦ ■ ■ ■ ■ ◦ ■ ■ ■ ■ ■ ◦ ■ ■ ◦ ■ ■ ■ ■ ■ ◦ ■ ■ ■ ■ ◦ □"], 
    "Line26" : ["□ ◦ ■ ■ ■ ■ ◦ ■ ■ ■ ■ ■ ◦ ■ ■ ◦ ■ ■ ■ ■ ■ ◦ ■ ■ ■ ■ ◦ □"], 
    "Line27" : ["□ ● ◦ ◦ ■ ■ ◦ ◦ ◦ ◦ ◦ ¤ ¤ x x ¤ ¤ ◦ ◦ ◦ ◦ ◦ ■ ■ ◦ ◦ ● □"], 
    "Line28" : ["□ ■ ■ ◦ ■ ■ ◦ ■ ■ ◦ ■ ■ ■ ■ ■ ■ ■ ■ ◦ ■ ■ ◦ ■ ■ ◦ ■ ■ □"], 
    "Line29" : ["□ ■ ■ ◦ ■ ■ ◦ ■ ■ ◦ ■ ■ ■ ■ ■ ■ ■ ■ ◦ ■ ■ ◦ ■ ■ ◦ ■ ■ □"], 
    "Line30" : ["□ ◦ ◦ ◦ ◦ ◦ ◦ ■ ■ ◦ ◦ ◦ ◦ ■ ■ ◦ ◦ ◦ ◦ ■ ■ ◦ ◦ ◦ ◦ ◦ ◦ □"], 
    "Line31" : ["□ ◦ ■ ■ ■ ■ ■ ■ ■ ■ ■ ■ ◦ ■ ■ ◦ ■ ■ ■ ■ ■ ■ ■ ■ ■ ■ ◦ □"], 
    "Line32" : ["□ ◦ ■ ■ ■ ■ ■ ■ ■ ■ ■ ■ ◦ ■ ■ ◦ ■ ■ ■ ■ ■ ■ ■ ■ ■ ■ ◦ □"], 
    "Line33" : ["□ ◦ ◦ ◦ ◦ ◦ ◦ ◦ ◦ ◦ ◦ ◦ ◦ ◦ ◦ ◦ ◦ ◦ ◦ ◦ ◦ ◦ ◦ ◦ ◦ ◦ ◦ □"], 
    "Line34" : ["□ □ □ □ □ □ □ □ □ □ □ □ □ □ □ □ □ □ □ □ □ □ □ □ □ □ □ □"], 
    "Line35" : ["/ / / / / / / / / / / / / / / / / / / / / / / / / / / /"], 
    "Line36" : ["/ / / / / / / / / / / / / / / / / / / / / / / / / / / /"]
}